000000000000
000000000000
000111110000
000143310000
000133311100
001112324100
001432511100
001111231000
000014331000
000011111000
000000000000
000000000000