000000000000
000000000000
000111100000
000135111000
000132331000
001113131100
001413133100
001423313100
001433323100
001111111100
000000000000
000000000000