000111110000
000133310000
011131311100
013331323100
013442443100
013333323100
011111211100
000013310000
000015310000
000013310000
000011110000
000000000000
