000000000000
000000000000
000111111000
000143441000
000143241000
001113321100
001323323100
001312313100
001333533100
001111111100
000000000000
000000000000
